<levels>
  <level>
    <id>001</id>
    <name>Level 1</name>
    <description>First Level</description>
      <map>
	1 1 1
	1 1 1
      </map>
    </level>
  <level>
    <id>002</id>
    <name>Level 2</name>
    <description>First Level</description>
      <map>
      1 1 1 1 1 1 1 1 1 1 1 1 1 1 1 1
      1 3 3 1 0 0 0 0 0 0 1 3 3 3 3 1
      1 3 3 1 0 0 0 0 0 0 1 3 3 3 3 1
      1 3 3 1 0 0 0 0 0 0 1 3 3 3 3 1
      1 3 3 1 1 1 0 0 1 1 1 3 3 3 3 1
      1 3 3 3 3 1 0 0 1 3 3 3 3 3 3 1
      1 3 3 3 3 1 0 0 1 3 3 3 3 3 3 1
      1 3 3 3 3 1 0 0 1 3 3 3 3 3 3 1
      1 3 3 1 1 1 0 0 1 1 1 3 3 3 3 1
      1 3 3 1 0 0 0 0 0 0 1 3 3 3 3 1
      1 3 3 1 0 0 0 0 0 0 1 3 3 3 3 1
      1 3 3 1 0 0 0 0 0 0 1 3 3 3 3 1
      1 1 1 1 1 1 1 1 1 1 1 1 1 1 1 1
      </map>
      <mediumMap>
      0 0 0 0 0 0 0 0 0 0 0 0 0 0 0 0
      0 0 0 0 1 1 1 1 1 1 0 0 0 0 0 0
      0 0 0 0 1 1 1 1 1 1 0 0 0 0 0 0
      0 0 0 0 1 1 1 1 1 1 0 0 0 0 0 0
      0 0 0 0 0 0 3 3 0 0 0 0 0 0 0 0
      0 0 0 0 0 0 3 3 0 0 0 0 0 0 0 0
      0 0 0 0 0 0 3 3 0 0 0 0 0 0 0 0
      0 0 0 0 0 0 3 3 0 0 0 0 0 0 0 0
      0 0 0 0 0 0 3 3 0 0 0 0 0 0 0 0
      0 0 0 0 2 2 2 2 2 2 0 0 0 0 0 0
      0 0 0 0 2 2 2 2 2 2 0 0 0 0 0 0
      0 0 0 0 2 2 2 2 2 2 0 0 0 0 0 0
      0 0 0 0 0 0 0 0 0 0 0 0 0 0 0 0
      </mediumMap>
    </level>
</levels>
